#######################################################################
#                         $          #                                #
#                  ##############    #                                #
#     #########           #          #       O     ############       #
#             #$          #    #######             #          #       #
#             #######     #          ###############          #       #
#             #           #                   #        #      #       #
#     *       #      ######    ########       #        #      #       #
#                                 $   #                #              #
#######################################################################
